50,50; 80,40; 90,90
120,60; 150,80; 160,50; 130,30
220,40; 250,60; 260,90; 230,100
320,30; 350,50; 370,80; 340,100; 310,90
420,60; 450,40; 480,70; 460,100; 430,90; 410,80
520,50; 550,30; 580,60; 570,90; 530,100
620,40; 650,70; 670,90; 640,100; 610,80
720,60; 750,40; 770,80; 740,100; 710,90
820,50; 850,30; 870,70; 860,100
920,60; 950,40; 970,80; 940,100; 910,90; 930,50
50,150; 80,130; 90,170; 60,180
140,140; 160,170; 130,190
220,130; 250,160; 260,190; 230,200
320,120; 350,150; 370,180; 340,200
420,130; 450,160; 470,190; 460,210; 430,200
520,140; 550,160; 570,190; 540,210
620,120; 650,140; 670,160; 640,190; 610,180
720,150; 750,130; 770,170; 740,190; 710,180
820,140; 850,160; 870,190; 860,210; 830,200
920,130; 950,160; 970,180; 940,200
50,250; 80,230; 90,270; 60,280; 40,260
140,240; 160,260; 130,280
220,230; 250,260; 260,290; 230,300
320,220; 350,250; 370,280; 340,300; 310,290
420,230; 450,260; 470,290; 460,310; 430,300
520,240; 550,260; 570,290; 540,310
620,220; 650,240; 670,260; 640,290; 610,280
720,250; 750,230; 770,270; 740,290; 710,280
820,240; 850,260; 870,290; 860,310; 830,300
920,230; 950,260; 970,280; 940,300
